"lang"
{
"Language"	"schinese"
"Tokens"
{
"chat_filterbutton"	"聊天过滤"
"[english]chat_filterbutton"	"Filters"
"filter_joinleave"	"加入与离开提示"
"[english]filter_joinleave"	"Joins/Leaves"
"filter_namechange"	"玩家姓名改动"
"[english]filter_namechange"	"Name Changes"
"filter_publicchat"	"公共聊天"
"[english]filter_publicchat"	"Public Chat"
"filter_servermsg"	"来自服务器的消息"
"[english]filter_servermsg"	"Server Messages"
"filter_teamchange"	"团队变更"
"[english]filter_teamchange"	"Team Changes"
"filter_achievement"	"成就通知"
"[english]filter_achievement"	"Achievement Announce"
"chat_say"	"发言："
"[english]chat_say"	"Say:"
"chat_say_team"	"发言（团队）："
"[english]chat_say_team"	"Say (TEAM):"
"chat_say_coach"	"发言（对学员们）："
"[english]chat_say_coach"	"Say (TO STUDENTS):"
"chat_say_student"	"发言（对教练）："
"[english]chat_say_student"	"Say (TO COACH):"
"chat_sourcetv"	"（Dota TV）%s1"
"[english]chat_sourcetv"	"(Dota TV) %s1"
}
}
