"lang"
{
"Language"	"german"
"Tokens"
{
"chat_filterbutton"	"Filter"
"[english]chat_filterbutton"	"Filters"
"filter_joinleave"	"Einklinken/Verlassen"
"[english]filter_joinleave"	"Joins/Leaves"
"filter_namechange"	"Namensänderungen"
"[english]filter_namechange"	"Name Changes"
"filter_publicchat"	"Öffentlicher Chat"
"[english]filter_publicchat"	"Public Chat"
"filter_servermsg"	"Servermeldungen"
"[english]filter_servermsg"	"Server Messages"
"filter_teamchange"	"Teamänderungen"
"[english]filter_teamchange"	"Team Changes"
"filter_achievement"	"Errungenschaftsmeldungen"
"[english]filter_achievement"	"Achievement Announce"
"chat_say"	"Nachricht:"
"[english]chat_say"	"Say:"
"chat_say_team"	"Nachricht (TEAM):"
"[english]chat_say_team"	"Say (TEAM):"
"chat_say_coach"	"Nachricht (AN SCHÜLER):"
"[english]chat_say_coach"	"Say (TO STUDENTS):"
"chat_say_student"	"Nachricht (AN MENTOR):"
"[english]chat_say_student"	"Say (TO COACH):"
"chat_sourcetv"	"(Dota-TV) %s1"
"[english]chat_sourcetv"	"(Dota TV) %s1"
}
}
