"lang"
{
"Language"	"finnish"
"Tokens"
{
"chat_filterbutton"	"Suodattimet"
"[english]chat_filterbutton"	"Filters"
"filter_joinleave"	"Liittymiset/poistumiset"
"[english]filter_joinleave"	"Joins/Leaves"
"filter_namechange"	"Nimien muutokset"
"[english]filter_namechange"	"Name Changes"
"filter_publicchat"	"Julkinen juttelu"
"[english]filter_publicchat"	"Public Chat"
"filter_servermsg"	"Palvelimen viestit"
"[english]filter_servermsg"	"Server Messages"
"filter_teamchange"	"Tiimien muutokset"
"[english]filter_teamchange"	"Team Changes"
"filter_achievement"	"Saavutusilmoitukset"
"[english]filter_achievement"	"Achievement Announce"
"chat_say"	"Sano:"
"[english]chat_say"	"Say:"
"chat_say_team"	"Sano (TIIMI):"
"[english]chat_say_team"	"Say (TEAM):"
"chat_say_coach"	"Sano (OPPILAILLE):"
"[english]chat_say_coach"	"Say (TO STUDENTS):"
"chat_say_student"	"Sano (VALMENTAJALLE):"
"[english]chat_say_student"	"Say (TO COACH):"
"chat_sourcetv"	"(Dota TV) %s1"
"[english]chat_sourcetv"	"(Dota TV) %s1"
}
}
