"lang"
{
"Language"	"bulgarian"
"Tokens"
{
"chat_filterbutton"	"Филтри"
"[english]chat_filterbutton"	"Filters"
"filter_joinleave"	"Присъединявания/напускания"
"[english]filter_joinleave"	"Joins/Leaves"
"filter_namechange"	"Промени в прякорите"
"[english]filter_namechange"	"Name Changes"
"filter_publicchat"	"Публичен чат"
"[english]filter_publicchat"	"Public Chat"
"filter_servermsg"	"Сървърни съобщения"
"[english]filter_servermsg"	"Server Messages"
"filter_teamchange"	"Промяна на отборите"
"[english]filter_teamchange"	"Team Changes"
"filter_achievement"	"Съобщение за достигнато постижение"
"[english]filter_achievement"	"Achievement Announce"
"chat_say"	"Кажете:"
"[english]chat_say"	"Say:"
"chat_say_team"	"Кажете (ДО ОТБОРА):"
"[english]chat_say_team"	"Say (TEAM):"
"chat_say_coach"	"Кажете (ДО УЧЕНИЦИТЕ):"
"[english]chat_say_coach"	"Say (TO STUDENTS):"
"chat_say_student"	"Кажете (ДО ТРЕНЬОРА):"
"[english]chat_say_student"	"Say (TO COACH):"
"chat_sourcetv"	"(Dota ТВ) %s1"
"[english]chat_sourcetv"	"(Dota TV) %s1"
}
}
